###################
#   Y  Y          #
#          o  o   #
#                 #
#~~~~~~~~~~~~~~~~~#
#~~~~~~~~~~~~~~~~~#
#~~~~~~~~~~~~~~~~~#
#                 #
#####=####   .    #
#    .   ####=#####
#####=####   .    #
#                 #
######### #########
#       # #       #
# O   O     O   O #
#~~~~~~~~~~~~~~~~~#
#~#~~~~~~~~~~~~~#~#
#~~~~#~~~~~~~#~~~~#
#~~~~~~~# #~~~~~~~#
#                 #
#   @         @   #
#                 #
#        X        #
###################
